100000100011f
1000001001100
1000001111000
1001s11001000
1001000001011
1001100001110
1000100000011
1011100000010
1110111111110