s000
1111
000f
0000#
000s000001000111111111111
0001000001001100100000001
0001000001111000110000011
1101k01111001000011000110
0001001000001011001000100
0111001100001110001000100
1101000100000011101000100
1001011100000010111011100
100d110111111110010010000
1000010001000010010011d1f
1000110001000010010001000
11111000011000000100010k1
0010000000100000010001001
0010001110100000000001001
1110001011100111001111001
1000001000000001000000001
1110001111000001111000001
0010000100000000100001111
0010000111111111111111001
1110000000000000000000001#
00s00
11111
10d0k
k0f00#
1111111111111111111111111111111111111ddd1f00
00100100001000001000000000000000000000000000
00100100001000000100000000000011100000111011
00100100001000000100000000001110111000101110
00100100001100000100000000001000001111100010
01100000k00110000111111111111000000001000010
11000000100010000000000000001000000001000000
10000000100011111000000000001000000001000000
10001110111000001110000000001000000001111100
11111010001100000011000000001000000001000100
00000010000111000001111111111000000001000100
00111111110001111100000000000000000001000100
00100000010000000111100000000000000000000100
00100000011111110000111000000000000000001110
00110000000000010000001000000000000001111010
00011110111111110000001000010011111001000010
01110000001000000011111001111000001001000010
01000000001000000010000011001000001001000010
01000001111000000010000110001000001011000011
01000000000000000010000100001111111110000001
0111111k000000000011111100000000000011100001
00000000000000000010000000000000000001000001
00000010001111111111111110000000000001000001
11111110001000000000000010000000000111000001
k0000100000000000000000000001111100000000001
00001111111111111111111111111000111111111111