000s000001000111111111111
0001000001001100100000001
000f000001111000110000011
1101001111001000011000110
0001001000001011001000100
0111001100001110001000100
1101000100000011101000100
1001011100000010111011100
1001110111111110010010000
1000010001000010010011000
1000110001000010010001000
1111100001100000010001011
0010000000100000010001001
0010001110100000000001001
1110001011100111001111001
1000001000000001000000001
1110001111000001111000001
0010000100000000100001111
0010000111111111111111001
1110000000000000000000001